11111111111111111111111111
10E000000000000000000000P1
10000000000000000000000001
10000000000000000CCCCCCC01
10000000000000000000000001
10000000000000000000000001
11111111111111111111111111