111111111111111111111111111111111111111111111111111111111111
1C0000000000000000000000000000000000000000000000000000000001
100000000001111111111111111111110000111111111111111111111111
10000000000000000E0C00000000000000000000000000000000000000P1
100000000000100001111111111111111111111111111111111111111111
100000000C111000000000C1000000000000000000000000000000000001
10000001000010000C000000000000000000000000000000000000000001
100000010000100000000000000000000000000000000000000000000001
100000010000111111111111100000000000000000000000000000000001
1C0000010000000000000000100000000000000000000000000000000001
111111110000000000000000100000000000000000000000000000000001
10000000000000000000000010000000000C000000000000000000000001
1000000000000000000000001000000000000000000000000000000000C1
100000000000000000000000100000000000000000000000000000000001
100000000000000000000000100000000000000000000000000000000001
100000000000000000000000100000000000000000000000000000000001
100000000000000000000000100000000000000000000000000000000001
100000000000000000000000100000000000000000000000000000000001
100000000000000000000000100000000000000000000000000000000001
100000000000000000000000100000000000000000000000000000000001
100000000000000000000000100000000000000000000000000000000001
100000000000000000000000100000000000000000000000000000000001
100000000000000000000000100000000000000000000000000000000001
100000000000000000000000100000000000000000000000000000000001
100000000000000000000000100000000000000000000000000000000001
100000000000000000000000100000000000000000000000000000000001
100000000000000000000000100000000000000000000000000000000001
100000000000000000000000100000000000000000000000000000000001
100000000000000000000000100000000000000000000000000000000001
100000000000000000000000100000000000000000000000000000000001
100000000000000000000000100000000000000000000000000000000001
111111111111111111111111111111111111111111111111111111111111