111111111
1E1111111
1C1111111
100C000P1
111111111